28x36
1 1 1 2 1 1 1 1 1 1 1 1 1 1 1 1 1 1 1 1 1 1 1 1 2 1 1 1
1 1 1 2 1 1 1 1 1 1 1 1 1 1 1 1 1 1 1 1 1 1 1 1 2 1 1 1
1 2 2 2 2 2 4 1 1 1 1 1 1 1 1 1 1 1 1 1 1 2 2 2 2 2 2 1
1 1 1 1 1 1 2 1 1 1 1 1 1 1 1 1 1 1 1 1 1 2 1 1 1 1 2 1
1 2 2 2 2 2 3 2 2 2 2 2 2 1 1 2 2 2 2 2 2 5 2 2 2 2 2 1
1 2 1 1 1 1 2 1 1 1 1 1 2 1 1 2 1 1 1 1 1 2 1 1 1 1 2 1
1 2 1 1 1 1 2 1 1 1 1 1 2 1 1 2 1 1 1 1 1 2 1 1 1 1 2 1
1 2 1 1 1 1 2 1 1 1 1 1 2 1 1 2 1 1 1 1 1 2 1 1 1 1 2 1
1 2 2 2 2 2 2 2 2 2 2 2 2 1 1 2 2 2 2 2 2 2 2 2 2 2 2 1
1 2 1 1 1 1 2 1 1 2 1 1 1 1 1 1 1 1 2 1 1 2 1 1 1 1 2 1
1 2 1 1 1 1 2 1 1 2 1 1 1 1 1 1 1 1 2 1 1 2 1 1 1 1 2 1
1 2 2 2 2 2 2 1 1 2 2 2 2 1 1 2 2 2 2 1 1 2 2 2 2 2 2 1
1 1 1 2 1 1 2 1 1 1 1 1 2 1 1 2 1 1 1 1 1 2 1 1 2 1 1 1
1 1 1 2 1 1 2 1 1 1 1 1 2 1 1 2 1 1 1 1 1 2 1 1 2 1 1 1
1 1 1 2 1 1 2 1 1 2 2 9 2 9 2 9 2 9 2 1 1 2 1 1 2 1 1 1
1 1 1 2 1 1 2 1 1 2 1 1 1 1 1 1 1 1 2 1 1 2 1 1 2 1 1 1
1 1 1 2 1 1 2 1 1 2 1 2 2 7 2 2 2 1 2 1 1 2 1 1 2 1 1 1
8 2 2 2 3 1 2 2 2 2 1 2 1 1 1 1 2 1 2 2 2 2 1 6 2 2 2 2
1 2 1 1 2 1 2 1 1 2 1 2 1 1 1 1 2 1 2 1 1 2 1 2 1 1 2 1
1 2 1 1 2 1 2 1 1 2 1 2 1 1 1 1 2 1 2 1 1 2 1 2 1 1 2 1
1 2 1 1 2 1 2 1 1 2 9 2 9 2 9 2 9 2 2 1 1 2 1 2 1 1 2 1
1 2 1 1 2 1 2 1 1 2 1 1 1 1 1 1 1 1 2 1 1 2 1 2 1 1 2 1
1 2 1 1 2 1 2 1 1 2 1 1 1 1 1 1 1 1 2 1 1 2 1 2 1 1 2 1
1 2 2 2 2 2 2 2 2 2 2 2 2 1 1 2 2 2 2 2 2 2 2 2 2 2 2 1
1 2 1 1 1 1 2 1 1 1 1 1 2 1 1 2 1 1 1 1 1 2 1 1 1 1 2 1
1 2 1 1 1 1 2 1 1 1 1 1 2 1 1 2 1 1 1 1 1 2 1 1 1 1 2 1
1 2 2 2 1 1 2 2 2 2 2 2 2 2 2 2 2 2 2 2 2 2 1 1 2 2 2 1
1 1 1 2 1 1 2 1 1 2 1 1 1 1 1 1 1 1 2 1 1 2 1 1 2 1 1 1
1 1 1 2 1 1 2 1 1 2 1 1 1 1 1 1 1 1 2 1 1 2 1 1 2 1 1 1
1 2 2 2 2 2 5 1 1 2 2 2 2 1 1 2 2 2 2 1 1 2 2 2 2 2 2 1
1 2 1 1 1 1 1 1 1 1 1 1 2 1 1 2 1 1 1 1 1 1 1 1 1 1 2 1
1 2 1 1 1 1 1 1 1 1 1 1 2 1 1 2 1 1 1 1 1 1 1 1 1 1 2 1
1 2 2 2 2 2 2 2 2 2 2 2 2 2 2 2 2 2 2 2 2 2 2 2 2 2 2 1
1 1 1 2 1 1 1 1 1 1 1 1 1 1 1 1 1 1 1 1 1 1 1 1 2 1 1 1
1 1 1 2 1 1 1 1 1 1 1 1 1 1 1 1 1 1 1 1 1 1 1 1 2 1 1 1
1 1 1 2 1 1 1 1 1 1 1 1 1 1 1 1 1 1 1 1 1 1 1 1 2 1 1 1